station_id,district_name,available_electric_bikes,available_mechanical_bikes,available_bikes,available_docks,status,last_update
21952,Meudon,8,24,32,10,1,2023-05-28 19:52:51
21951,Meudon,1,0,1,21,1,2023-05-28 19:52:51
21953,Meudon,5,0,5,14,1,2023-05-28 19:52:51
21954,Meudon,8,3,11,11,1,2023-05-28 19:52:51
21952,Meudon,6,25,31,11,1,2023-05-28 20:02:53
21951,Meudon,1,0,1,21,1,2023-05-28 20:02:53
21953,Meudon,3,0,3,16,1,2023-05-28 20:02:53
21954,Meudon,8,3,11,11,1,2023-05-28 20:02:53
21952,Meudon,6,25,31,11,1,2023-05-28 20:12:55
21951,Meudon,1,0,1,21,1,2023-05-28 20:12:55
21953,Meudon,3,0,3,16,1,2023-05-28 20:12:55
21954,Meudon,7,2,9,13,1,2023-05-28 20:12:55
21952,Meudon,6,25,31,11,1,2023-05-28 20:22:56
21951,Meudon,1,0,1,21,1,2023-05-28 20:22:56
21953,Meudon,3,0,3,16,1,2023-05-28 20:22:56
21954,Meudon,7,2,9,13,1,2023-05-28 20:22:56
21952,Meudon,7,25,32,10,1,2023-05-28 20:32:58
21951,Meudon,1,0,1,21,1,2023-05-28 20:32:58
21953,Meudon,3,0,3,16,1,2023-05-28 20:32:58
21954,Meudon,7,2,9,13,1,2023-05-28 20:32:58
21952,Meudon,7,25,32,10,1,2023-05-28 20:43:00
21951,Meudon,1,0,1,21,1,2023-05-28 20:43:00
21953,Meudon,3,0,3,16,1,2023-05-28 20:43:00
21954,Meudon,7,2,9,13,1,2023-05-28 20:43:00
21952,Meudon,8,24,32,10,1,2023-05-28 20:53:02
21951,Meudon,1,0,1,21,1,2023-05-28 20:53:02
21953,Meudon,3,0,3,16,1,2023-05-28 20:53:02
21954,Meudon,8,2,10,12,1,2023-05-28 20:53:02
21952,Meudon,7,24,31,11,1,2023-05-28 21:03:04
21951,Meudon,1,0,1,21,1,2023-05-28 21:03:04
21953,Meudon,3,0,3,16,1,2023-05-28 21:03:04
21954,Meudon,10,2,12,10,1,2023-05-28 21:03:04
21952,Meudon,4,9,13,26,1,2023-05-29 10:59:59
21951,Meudon,2,10,12,10,1,2023-05-29 10:59:59
21953,Meudon,6,0,6,14,1,2023-05-29 11:00:00
21954,Meudon,7,2,9,14,1,2023-05-29 11:00:00
21952,Meudon,5,9,14,26,1,2023-05-29 11:10:02
21951,Meudon,2,8,10,12,1,2023-05-29 11:10:03
21953,Meudon,6,0,6,14,1,2023-05-29 11:10:03
21954,Meudon,8,2,10,13,1,2023-05-29 11:10:03
21952,Meudon,5,10,15,25,1,2023-05-29 11:20:04
21951,Meudon,2,8,10,12,1,2023-05-29 11:20:04
21953,Meudon,6,0,6,14,1,2023-05-29 11:20:04
21954,Meudon,8,2,10,13,1,2023-05-29 11:20:04
21952,Meudon,5,10,15,25,1,2023-05-29 11:30:06
21951,Meudon,2,8,10,12,1,2023-05-29 11:30:06
21953,Meudon,6,0,6,14,1,2023-05-29 11:30:06
21954,Meudon,8,2,10,13,1,2023-05-29 11:30:06
21952,Meudon,4,10,14,26,1,2023-05-29 11:40:08
21951,Meudon,2,8,10,12,1,2023-05-29 11:40:08
21953,Meudon,6,0,6,14,1,2023-05-29 11:40:08
21954,Meudon,8,2,10,13,1,2023-05-29 11:40:08
21952,Meudon,4,10,14,26,1,2023-05-29 11:50:11
21951,Meudon,2,8,10,12,1,2023-05-29 11:50:11
21953,Meudon,5,0,5,15,1,2023-05-29 11:50:11
21954,Meudon,6,2,8,15,1,2023-05-29 11:50:11
21952,Meudon,4,10,14,26,1,2023-05-29 12:00:16
21951,Meudon,2,8,10,12,1,2023-05-29 12:00:16
21953,Meudon,5,0,5,15,1,2023-05-29 12:00:16
21954,Meudon,6,2,8,15,1,2023-05-29 12:00:16
21952,Meudon,4,10,14,26,1,2023-05-29 12:10:18
21951,Meudon,2,8,10,12,1,2023-05-29 12:10:18
21953,Meudon,4,0,4,16,1,2023-05-29 12:10:18
21954,Meudon,6,2,8,15,1,2023-05-29 12:10:19
21952,Meudon,5,10,15,25,1,2023-05-29 12:20:21
21951,Meudon,2,8,10,12,1,2023-05-29 12:20:21
21953,Meudon,4,0,4,16,1,2023-05-29 12:20:21
21954,Meudon,6,2,8,15,1,2023-05-29 12:20:21
21952,Meudon,5,11,16,24,1,2023-05-29 12:30:23
21951,Meudon,2,8,10,12,1,2023-05-29 12:30:23
21953,Meudon,6,0,6,14,1,2023-05-29 12:30:23
21954,Meudon,5,2,7,16,1,2023-05-29 12:30:23
21952,Meudon,5,11,16,24,1,2023-05-29 12:40:25
21951,Meudon,2,8,10,12,1,2023-05-29 12:40:25
21953,Meudon,6,0,6,14,1,2023-05-29 12:40:26
21954,Meudon,9,2,11,12,1,2023-05-29 12:40:26
21952,Meudon,5,11,16,24,1,2023-05-29 12:50:27
21951,Meudon,2,8,10,12,1,2023-05-29 12:50:27
21953,Meudon,6,0,6,14,1,2023-05-29 12:50:27
21954,Meudon,9,2,11,12,1,2023-05-29 12:50:27
21952,Meudon,5,11,16,24,1,2023-05-29 13:00:29
21951,Meudon,2,7,9,13,1,2023-05-29 13:00:29
21953,Meudon,6,0,6,14,1,2023-05-29 13:00:29
21954,Meudon,9,2,11,12,1,2023-05-29 13:00:29
21952,Meudon,5,11,16,24,1,2023-05-29 13:10:31
21951,Meudon,2,9,11,11,1,2023-05-29 13:10:31
21953,Meudon,6,0,6,14,1,2023-05-29 13:10:31
21954,Meudon,9,3,12,11,1,2023-05-29 13:10:31
21952,Meudon,5,11,16,24,1,2023-05-29 13:20:33
21951,Meudon,2,9,11,11,1,2023-05-29 13:20:33
21953,Meudon,6,0,6,14,1,2023-05-29 13:20:33
21954,Meudon,9,3,12,11,1,2023-05-29 13:20:33
21952,Meudon,5,11,16,24,1,2023-05-29 13:30:35
21951,Meudon,2,9,11,11,1,2023-05-29 13:30:35
21953,Meudon,6,0,6,14,1,2023-05-29 13:30:35
21954,Meudon,9,3,12,11,1,2023-05-29 13:30:35
21952,Meudon,4,11,15,25,1,2023-05-29 13:40:37
21951,Meudon,1,8,9,13,1,2023-05-29 13:40:37
21953,Meudon,6,0,6,14,1,2023-05-29 13:40:37
21954,Meudon,9,3,12,11,1,2023-05-29 13:40:37
21951,Meudon,1,8,9,13,1,2023-05-29 13:50:39
21952,Meudon,4,11,15,25,1,2023-05-29 13:50:39
21953,Meudon,5,0,5,15,1,2023-05-29 13:50:39
21954,Meudon,9,3,12,11,1,2023-05-29 13:50:39
21952,Meudon,3,11,14,26,1,2023-05-29 14:00:41
21951,Meudon,1,8,9,13,1,2023-05-29 14:00:41
21953,Meudon,5,0,5,15,1,2023-05-29 14:00:41
21954,Meudon,9,4,13,10,1,2023-05-29 14:00:41
21952,Meudon,1,11,12,28,1,2023-05-29 14:10:43
21951,Meudon,1,8,9,13,1,2023-05-29 14:10:43
21953,Meudon,4,0,4,16,1,2023-05-29 14:10:43
21954,Meudon,9,4,13,10,1,2023-05-29 14:10:43
21952,Meudon,0,11,11,29,1,2023-05-29 14:20:46
21951,Meudon,2,8,10,12,1,2023-05-29 14:20:46
21953,Meudon,4,0,4,16,1,2023-05-29 14:20:46
21954,Meudon,9,4,13,10,1,2023-05-29 14:20:46
21952,Meudon,0,12,12,28,1,2023-05-29 14:30:48
21951,Meudon,2,8,10,12,1,2023-05-29 14:30:48
21953,Meudon,3,0,3,17,1,2023-05-29 14:30:49
21954,Meudon,10,4,14,9,1,2023-05-29 14:30:49
21952,Meudon,0,11,11,29,1,2023-05-29 14:40:52
21951,Meudon,2,8,10,12,1,2023-05-29 14:40:52
21953,Meudon,2,0,2,18,1,2023-05-29 14:40:52
21954,Meudon,10,4,14,9,1,2023-05-29 14:40:53
21952,Meudon,0,10,10,30,1,2023-05-29 14:51:05
21951,Meudon,2,8,10,12,1,2023-05-29 14:51:05
21953,Meudon,2,0,2,18,1,2023-05-29 14:51:06
21954,Meudon,11,4,15,8,1,2023-05-29 14:51:06
21952,Meudon,1,9,10,30,1,2023-05-29 15:01:09
21951,Meudon,2,8,10,12,1,2023-05-29 15:01:10
21953,Meudon,2,0,2,18,1,2023-05-29 15:01:10
21954,Meudon,11,4,15,8,1,2023-05-29 15:01:10
21952,Meudon,1,8,9,31,1,2023-05-29 15:11:18
21951,Meudon,3,8,11,11,1,2023-05-29 15:11:18
21953,Meudon,2,0,2,18,1,2023-05-29 15:11:19
21954,Meudon,12,4,16,7,1,2023-05-29 15:11:19
21952,Meudon,1,8,9,31,1,2023-05-29 15:21:22
21951,Meudon,3,8,11,11,1,2023-05-29 15:21:22
21953,Meudon,2,0,2,18,1,2023-05-29 15:21:22
21954,Meudon,12,4,16,7,1,2023-05-29 15:21:23
21952,Meudon,2,5,7,33,1,2023-05-29 15:31:25
21951,Meudon,2,8,10,12,1,2023-05-29 15:31:25
21953,Meudon,2,0,2,18,1,2023-05-29 15:31:25
21954,Meudon,12,4,16,7,1,2023-05-29 15:31:26
21952,Meudon,1,6,7,33,1,2023-05-29 15:41:28
21951,Meudon,3,8,11,11,1,2023-05-29 15:41:28
21953,Meudon,2,0,2,18,1,2023-05-29 15:41:28
21954,Meudon,12,4,16,7,1,2023-05-29 15:41:29
21952,Meudon,2,7,9,31,1,2023-05-29 15:51:31
21951,Meudon,3,8,11,11,1,2023-05-29 15:51:31
21953,Meudon,1,0,1,19,1,2023-05-29 15:51:32
21954,Meudon,11,4,15,8,1,2023-05-29 15:51:32
21952,Meudon,2,6,8,32,1,2023-05-29 16:01:35
21951,Meudon,3,8,11,11,1,2023-05-29 16:01:35
21953,Meudon,1,0,1,19,1,2023-05-29 16:01:35
21954,Meudon,11,4,15,8,1,2023-05-29 16:01:35
21952,Meudon,2,6,8,32,1,2023-05-29 16:11:38
21951,Meudon,3,8,11,11,1,2023-05-29 16:11:38
21953,Meudon,1,0,1,19,1,2023-05-29 16:11:38
21954,Meudon,11,4,15,8,1,2023-05-29 16:11:39
21952,Meudon,2,6,8,32,1,2023-05-29 16:21:42
21951,Meudon,3,8,11,11,1,2023-05-29 16:21:42
21953,Meudon,1,0,1,19,1,2023-05-29 16:21:42
21954,Meudon,11,4,15,8,1,2023-05-29 16:21:42
21952,Meudon,2,6,8,32,1,2023-05-29 16:31:48
21951,Meudon,3,8,11,11,1,2023-05-29 16:31:48
21953,Meudon,1,0,1,19,1,2023-05-29 16:31:49
21954,Meudon,11,4,15,8,1,2023-05-29 16:31:49
21952,Meudon,2,6,8,32,1,2023-05-29 16:41:52
21951,Meudon,3,8,11,11,1,2023-05-29 16:41:52
21953,Meudon,1,0,1,19,1,2023-05-29 16:41:52
21954,Meudon,11,4,15,8,1,2023-05-29 16:41:53
21952,Meudon,2,6,8,32,1,2023-05-29 16:51:55
21951,Meudon,3,8,11,11,1,2023-05-29 16:51:55
21953,Meudon,1,0,1,19,1,2023-05-29 16:51:56
21954,Meudon,11,4,15,8,1,2023-05-29 16:51:56
21952,Meudon,2,6,8,32,1,2023-05-29 17:01:59
21951,Meudon,3,8,11,11,1,2023-05-29 17:01:59
21953,Meudon,1,0,1,19,1,2023-05-29 17:01:59
21954,Meudon,11,4,15,8,1,2023-05-29 17:02:00
21952,Meudon,2,6,8,32,1,2023-05-29 17:12:04
21951,Meudon,3,8,11,11,1,2023-05-29 17:12:04
21953,Meudon,1,0,1,19,1,2023-05-29 17:12:05
21954,Meudon,11,4,15,8,1,2023-05-29 17:12:05
21952,Meudon,2,6,8,32,1,2023-05-29 17:22:09
21951,Meudon,3,8,11,11,1,2023-05-29 17:22:09
21953,Meudon,1,0,1,19,1,2023-05-29 17:22:09
21954,Meudon,11,4,15,8,1,2023-05-29 17:22:10
21952,Meudon,2,6,8,32,1,2023-05-29 17:32:12
21951,Meudon,3,8,11,11,1,2023-05-29 17:32:12
21953,Meudon,1,0,1,19,1,2023-05-29 17:32:13
21954,Meudon,11,4,15,8,1,2023-05-29 17:32:13
21952,Meudon,2,6,8,32,1,2023-05-29 17:42:16
21951,Meudon,3,8,11,11,1,2023-05-29 17:42:16
21953,Meudon,1,0,1,19,1,2023-05-29 17:42:17
21954,Meudon,11,4,15,8,1,2023-05-29 17:42:17
21952,Meudon,2,6,8,32,1,2023-05-29 17:52:20
21951,Meudon,3,8,11,11,1,2023-05-29 17:52:20
21953,Meudon,1,0,1,19,1,2023-05-29 17:52:21
21954,Meudon,11,4,15,8,1,2023-05-29 17:52:21
21952,Meudon,2,6,8,32,1,2023-05-29 18:02:23
21951,Meudon,3,8,11,11,1,2023-05-29 18:02:23
21953,Meudon,1,0,1,19,1,2023-05-29 18:02:23
21954,Meudon,11,4,15,8,1,2023-05-29 18:02:23
21952,Meudon,2,6,8,32,1,2023-05-29 18:12:25
21951,Meudon,3,8,11,11,1,2023-05-29 18:12:25
21953,Meudon,1,0,1,19,1,2023-05-29 18:12:25
21954,Meudon,11,4,15,8,1,2023-05-29 18:12:25
21952,Meudon,2,6,8,32,1,2023-05-29 18:22:27
21951,Meudon,3,8,11,11,1,2023-05-29 18:22:27
21953,Meudon,1,0,1,19,1,2023-05-29 18:22:28
21954,Meudon,11,4,15,8,1,2023-05-29 18:22:28
21952,Meudon,2,6,8,32,1,2023-05-29 18:32:30
21951,Meudon,3,8,11,11,1,2023-05-29 18:32:31
21953,Meudon,1,0,1,19,1,2023-05-29 18:32:31
21954,Meudon,11,4,15,8,1,2023-05-29 18:32:31
21952,Meudon,2,6,8,32,1,2023-05-29 18:42:33
21951,Meudon,3,8,11,11,1,2023-05-29 18:42:33
21953,Meudon,1,0,1,19,1,2023-05-29 18:42:33
21954,Meudon,11,4,15,8,1,2023-05-29 18:42:33
21952,Meudon,2,6,8,32,1,2023-05-29 18:52:35
21951,Meudon,3,8,11,11,1,2023-05-29 18:52:35
21953,Meudon,1,0,1,19,1,2023-05-29 18:52:35
21954,Meudon,11,4,15,8,1,2023-05-29 18:52:35
21952,Meudon,2,6,8,32,1,2023-05-29 19:02:37
21951,Meudon,3,8,11,11,1,2023-05-29 19:02:37
21953,Meudon,1,0,1,19,1,2023-05-29 19:02:37
21954,Meudon,11,4,15,8,1,2023-05-29 19:02:37
21952,Meudon,2,6,8,32,1,2023-05-29 19:12:39
21951,Meudon,3,8,11,11,1,2023-05-29 19:12:39
21953,Meudon,1,0,1,19,1,2023-05-29 19:12:39
21954,Meudon,11,4,15,8,1,2023-05-29 19:12:39
21952,Meudon,2,6,8,32,1,2023-05-29 19:22:41
21951,Meudon,3,8,11,11,1,2023-05-29 19:22:41
21953,Meudon,1,0,1,19,1,2023-05-29 19:22:41
21954,Meudon,11,4,15,8,1,2023-05-29 19:22:42
21952,Meudon,2,6,8,32,1,2023-05-29 19:32:44
21951,Meudon,3,8,11,11,1,2023-05-29 19:32:44
21953,Meudon,1,0,1,19,1,2023-05-29 19:32:44
21954,Meudon,11,4,15,8,1,2023-05-29 19:32:44
21952,Meudon,2,6,8,32,1,2023-05-29 19:42:46
21951,Meudon,3,8,11,11,1,2023-05-29 19:42:46
21953,Meudon,1,0,1,19,1,2023-05-29 19:42:46
21954,Meudon,11,4,15,8,1,2023-05-29 19:42:46
21952,Meudon,2,6,8,32,1,2023-05-29 19:52:48
21951,Meudon,3,8,11,11,1,2023-05-29 19:52:48
21953,Meudon,1,0,1,19,1,2023-05-29 19:52:48
21954,Meudon,11,4,15,8,1,2023-05-29 19:52:48
21952,Meudon,2,6,8,32,1,2023-05-29 20:02:50
21951,Meudon,3,8,11,11,1,2023-05-29 20:02:50
21953,Meudon,1,0,1,19,1,2023-05-29 20:02:50
21954,Meudon,11,4,15,8,1,2023-05-29 20:02:50
21952,Meudon,2,6,8,32,1,2023-05-29 20:12:52
21951,Meudon,3,8,11,11,1,2023-05-29 20:12:52
21953,Meudon,1,0,1,19,1,2023-05-29 20:12:53
21954,Meudon,11,4,15,8,1,2023-05-29 20:12:53
21952,Meudon,2,6,8,32,1,2023-05-29 20:22:55
21951,Meudon,3,8,11,11,1,2023-05-29 20:22:55
21953,Meudon,1,0,1,19,1,2023-05-29 20:22:55
21954,Meudon,11,4,15,8,1,2023-05-29 20:22:55
21952,Meudon,2,6,8,32,1,2023-05-29 20:32:57
21951,Meudon,3,8,11,11,1,2023-05-29 20:32:57
21953,Meudon,1,0,1,19,1,2023-05-29 20:32:57
21954,Meudon,11,4,15,8,1,2023-05-29 20:32:57
21952,Meudon,2,6,8,32,1,2023-05-29 20:42:59
21951,Meudon,3,8,11,11,1,2023-05-29 20:42:59
21953,Meudon,1,0,1,19,1,2023-05-29 20:42:59
21954,Meudon,11,4,15,8,1,2023-05-29 20:42:59
21952,Meudon,2,6,8,32,1,2023-05-29 20:53:01
21951,Meudon,3,8,11,11,1,2023-05-29 20:53:01
21953,Meudon,1,0,1,19,1,2023-05-29 20:53:01
21954,Meudon,11,4,15,8,1,2023-05-29 20:53:01
21952,Meudon,2,6,8,32,1,2023-05-29 21:03:02
21951,Meudon,3,8,11,11,1,2023-05-29 21:03:02
21953,Meudon,1,0,1,19,1,2023-05-29 21:03:03
21954,Meudon,11,4,15,8,1,2023-05-29 21:03:03
21952,Meudon,1,0,1,41,1,2023-05-30 12:02:31
21951,Meudon,1,5,6,16,1,2023-05-30 12:02:31
21953,Meudon,0,0,0,20,1,2023-05-30 12:02:32
21954,Meudon,3,0,3,20,1,2023-05-30 12:02:32
21952,Meudon,0,0,0,42,1,2023-05-30 12:11:31
21951,Meudon,1,5,6,16,1,2023-05-30 12:11:31
21953,Meudon,0,0,0,20,1,2023-05-30 12:11:31
21954,Meudon,3,0,3,20,1,2023-05-30 12:11:31
21952,Meudon,0,0,0,42,1,2023-05-30 12:21:35
21951,Meudon,1,5,6,16,1,2023-05-30 12:21:35
21953,Meudon,0,0,0,20,1,2023-05-30 12:21:36
21954,Meudon,3,0,3,20,1,2023-05-30 12:21:36
21952,Meudon,0,0,0,42,1,2023-05-30 12:31:38
21951,Meudon,1,5,6,16,1,2023-05-30 12:31:38
21953,Meudon,0,0,0,20,1,2023-05-30 12:31:38
21954,Meudon,2,0,2,21,1,2023-05-30 12:31:38
21952,Meudon,2,0,2,40,1,2023-05-30 12:41:42
21951,Meudon,1,4,5,17,1,2023-05-30 12:41:42
21953,Meudon,0,0,0,20,1,2023-05-30 12:41:42
21954,Meudon,2,0,2,21,1,2023-05-30 12:41:43
21952,Meudon,2,0,2,40,1,2023-05-30 12:51:45
21951,Meudon,1,4,5,17,1,2023-05-30 12:51:45
21953,Meudon,0,0,0,20,1,2023-05-30 12:51:46
21954,Meudon,1,1,2,21,1,2023-05-30 12:51:46
21952,Meudon,1,1,2,40,1,2023-05-30 15:01:22
21951,Meudon,2,4,6,16,1,2023-05-30 15:01:22
21953,Meudon,1,0,1,19,1,2023-05-30 15:01:22
21954,Meudon,2,0,2,21,1,2023-05-30 15:01:22
21952,Meudon,1,1,2,40,1,2023-05-30 15:11:32
21951,Meudon,2,4,6,16,1,2023-05-30 15:11:32
21953,Meudon,1,0,1,19,1,2023-05-30 15:11:32
21954,Meudon,2,0,2,21,1,2023-05-30 15:11:33
21952,Meudon,2,1,3,39,1,2023-05-30 15:21:35
21951,Meudon,2,4,6,16,1,2023-05-30 15:21:35
21953,Meudon,1,0,1,19,1,2023-05-30 15:21:35
21954,Meudon,2,0,2,21,1,2023-05-30 15:21:35
21952,Meudon,3,1,4,38,1,2023-05-30 15:31:37
21951,Meudon,3,4,7,15,1,2023-05-30 15:31:37
21953,Meudon,1,0,1,19,1,2023-05-30 15:31:38
21954,Meudon,2,0,2,21,1,2023-05-30 15:31:38
21952,Meudon,3,1,4,38,1,2023-05-30 15:41:40
21951,Meudon,3,4,7,15,1,2023-05-30 15:41:40
21953,Meudon,0,0,0,20,1,2023-05-30 15:41:40
21954,Meudon,1,0,1,22,1,2023-05-30 15:41:40
21952,Meudon,2,1,3,39,1,2023-05-30 15:51:41
21951,Meudon,1,4,5,17,1,2023-05-30 15:51:41
21953,Meudon,0,0,0,20,1,2023-05-30 15:51:41
21954,Meudon,1,0,1,22,1,2023-05-30 15:51:42
21952,Meudon,4,1,5,37,1,2023-05-30 16:01:43
21951,Meudon,1,4,5,17,1,2023-05-30 16:01:43
21953,Meudon,0,0,0,20,1,2023-05-30 16:01:43
21954,Meudon,1,0,1,22,1,2023-05-30 16:01:43
21952,Meudon,4,0,4,38,1,2023-05-30 16:11:44
21951,Meudon,1,4,5,17,1,2023-05-30 16:11:44
21953,Meudon,0,0,0,20,1,2023-05-30 16:11:44
21954,Meudon,1,0,1,22,1,2023-05-30 16:11:45
21952,Meudon,4,0,4,38,1,2023-05-30 16:21:46
21951,Meudon,1,4,5,17,1,2023-05-30 16:21:46
21953,Meudon,0,0,0,20,1,2023-05-30 16:21:46
21954,Meudon,1,0,1,22,1,2023-05-30 16:21:46
21952,Meudon,5,0,5,37,1,2023-05-30 16:31:48
21951,Meudon,1,4,5,17,1,2023-05-30 16:31:48
21953,Meudon,0,0,0,20,1,2023-05-30 16:31:49
21954,Meudon,1,0,1,22,1,2023-05-30 16:31:49
21952,Meudon,6,0,6,36,1,2023-05-30 16:41:51
21951,Meudon,1,4,5,17,1,2023-05-30 16:41:51
21953,Meudon,0,0,0,20,1,2023-05-30 16:41:51
21954,Meudon,1,0,1,22,1,2023-05-30 16:41:52
21952,Meudon,5,1,6,36,1,2023-05-30 16:51:55
21951,Meudon,1,4,5,17,1,2023-05-30 16:51:55
21953,Meudon,0,0,0,20,1,2023-05-30 16:51:55
21954,Meudon,1,0,1,22,1,2023-05-30 16:51:56
21952,Meudon,4,0,4,38,1,2023-05-30 17:01:58
21951,Meudon,1,4,5,17,1,2023-05-30 17:01:58
21953,Meudon,0,0,0,20,1,2023-05-30 17:01:58
21954,Meudon,1,0,1,22,1,2023-05-30 17:01:59
21952,Meudon,3,0,3,39,1,2023-05-30 17:12:01
21951,Meudon,1,4,5,17,1,2023-05-30 17:12:01
21953,Meudon,0,0,0,20,1,2023-05-30 17:12:02
21954,Meudon,1,0,1,22,1,2023-05-30 17:12:02
21952,Meudon,3,0,3,39,1,2023-05-30 17:22:05
21951,Meudon,1,4,5,17,1,2023-05-30 17:22:05
21953,Meudon,0,0,0,20,1,2023-05-30 17:22:05
21954,Meudon,1,0,1,22,1,2023-05-30 17:22:06
21952,Meudon,0,1,1,41,1,2023-05-30 17:32:08
21951,Meudon,1,4,5,17,1,2023-05-30 17:32:08
21953,Meudon,0,0,0,20,1,2023-05-30 17:32:09
21954,Meudon,2,0,2,21,1,2023-05-30 17:32:09
21952,Meudon,0,1,1,41,1,2023-05-30 17:42:12
21951,Meudon,1,3,4,18,1,2023-05-30 17:42:12
21953,Meudon,0,0,0,20,1,2023-05-30 17:42:13
21954,Meudon,2,0,2,21,1,2023-05-30 17:42:13
21952,Meudon,3,1,4,38,1,2023-05-30 17:52:15
21951,Meudon,1,3,4,18,1,2023-05-30 17:52:16
21953,Meudon,1,0,1,19,1,2023-05-30 17:52:16
21954,Meudon,2,0,2,21,1,2023-05-30 17:52:16
21952,Meudon,4,1,5,37,1,2023-05-30 18:02:18
21951,Meudon,1,2,3,19,1,2023-05-30 18:02:18
21953,Meudon,1,0,1,19,1,2023-05-30 18:02:19
21954,Meudon,2,0,2,21,1,2023-05-30 18:02:19
21952,Meudon,3,0,3,39,1,2023-05-30 18:12:21
21951,Meudon,1,2,3,19,1,2023-05-30 18:12:21
21953,Meudon,1,0,1,19,1,2023-05-30 18:12:22
21954,Meudon,1,0,1,22,1,2023-05-30 18:12:22
21952,Meudon,4,0,4,38,1,2023-05-30 18:22:24
21951,Meudon,1,2,3,19,1,2023-05-30 18:22:24
21953,Meudon,2,0,2,18,1,2023-05-30 18:22:25
21954,Meudon,0,0,0,23,1,2023-05-30 18:22:25
21952,Meudon,2,1,3,39,1,2023-05-30 18:32:27
21951,Meudon,1,2,3,19,1,2023-05-30 18:32:27
21953,Meudon,2,0,2,18,1,2023-05-30 18:32:27
21954,Meudon,1,0,1,22,1,2023-05-30 18:32:28
21952,Meudon,2,2,4,38,1,2023-05-30 18:42:30
21951,Meudon,1,1,2,20,1,2023-05-30 18:42:30
21953,Meudon,2,0,2,18,1,2023-05-30 18:42:30
21954,Meudon,1,0,1,22,1,2023-05-30 18:42:30
21952,Meudon,1,3,4,38,1,2023-05-30 18:52:33
21951,Meudon,1,1,2,20,1,2023-05-30 18:52:33
21953,Meudon,0,0,0,20,1,2023-05-30 18:52:34
21954,Meudon,3,0,3,20,1,2023-05-30 18:52:34
21952,Meudon,1,5,6,36,1,2023-05-31 09:12:49
21951,Meudon,2,1,3,19,1,2023-05-31 09:12:49
21953,Meudon,1,1,2,18,1,2023-05-31 09:12:49
21954,Meudon,1,1,2,20,1,2023-05-31 09:12:49
21952,Meudon,1,4,5,37,1,2023-05-31 09:22:51
21951,Meudon,3,1,4,18,1,2023-05-31 09:22:51
21953,Meudon,2,1,3,17,1,2023-05-31 09:22:51
21954,Meudon,1,1,2,20,1,2023-05-31 09:22:52
21952,Meudon,1,4,5,37,1,2023-05-31 09:32:53
21951,Meudon,3,1,4,18,1,2023-05-31 09:32:53
21953,Meudon,3,1,4,16,1,2023-05-31 09:32:53
21954,Meudon,0,1,1,21,1,2023-05-31 09:32:54
21952,Meudon,1,2,3,39,1,2023-05-31 09:42:57
21951,Meudon,3,0,3,19,1,2023-05-31 09:42:57
21953,Meudon,3,0,3,17,1,2023-05-31 09:42:57
21954,Meudon,0,1,1,21,1,2023-05-31 09:42:58
21951,Meudon,3,0,3,19,1,2023-05-31 09:53:03
21952,Meudon,1,1,2,40,1,2023-05-31 09:53:03
21953,Meudon,3,0,3,17,1,2023-05-31 09:53:03
21954,Meudon,0,1,1,21,1,2023-05-31 09:53:03
21951,Meudon,3,0,3,19,1,2023-05-31 10:03:07
21952,Meudon,1,1,2,40,1,2023-05-31 10:03:07
21953,Meudon,3,0,3,17,1,2023-05-31 10:03:07
21954,Meudon,0,1,1,21,1,2023-05-31 10:03:07
21952,Meudon,3,1,4,38,1,2023-05-31 10:13:11
21951,Meudon,3,0,3,19,1,2023-05-31 10:13:11
21953,Meudon,3,0,3,17,1,2023-05-31 10:13:11
21954,Meudon,5,1,6,16,1,2023-05-31 10:13:11
21952,Meudon,3,2,5,37,1,2023-05-31 10:23:13
21951,Meudon,3,0,3,19,1,2023-05-31 10:23:13
21953,Meudon,4,0,4,16,1,2023-05-31 10:23:13
21954,Meudon,5,0,5,17,1,2023-05-31 10:23:14
21952,Meudon,3,1,4,38,1,2023-05-31 10:33:16
21951,Meudon,3,1,4,18,1,2023-05-31 10:33:16
21953,Meudon,4,1,5,15,1,2023-05-31 10:33:16
21954,Meudon,5,0,5,17,1,2023-05-31 10:33:16
21952,Meudon,3,1,4,38,1,2023-05-31 10:43:22
21951,Meudon,4,1,5,17,1,2023-05-31 10:43:22
21953,Meudon,2,0,2,18,1,2023-05-31 10:43:22
21954,Meudon,5,0,5,17,1,2023-05-31 10:43:22
21952,Meudon,3,2,5,37,1,2023-05-31 10:53:25
21951,Meudon,4,1,5,17,1,2023-05-31 10:53:26
21953,Meudon,2,0,2,18,1,2023-05-31 10:53:26
21954,Meudon,6,0,6,16,1,2023-05-31 10:53:26
21952,Meudon,3,2,5,37,1,2023-05-31 11:03:29
21951,Meudon,4,1,5,17,1,2023-05-31 11:03:29
21953,Meudon,2,0,2,18,1,2023-05-31 11:03:29
21954,Meudon,6,0,6,16,1,2023-05-31 11:03:30
21952,Meudon,3,2,5,37,1,2023-05-31 11:13:32
21951,Meudon,4,1,5,17,1,2023-05-31 11:13:32
21953,Meudon,2,0,2,18,1,2023-05-31 11:13:32
21954,Meudon,6,0,6,16,1,2023-05-31 11:13:33
21952,Meudon,2,2,4,38,1,2023-05-31 12:13:01
21951,Meudon,4,1,5,17,1,2023-05-31 12:13:01
21953,Meudon,1,0,1,19,1,2023-05-31 12:13:02
21954,Meudon,6,1,7,15,1,2023-05-31 12:13:02
21952,Meudon,2,2,4,38,1,2023-05-31 12:23:04
21951,Meudon,4,1,5,17,1,2023-05-31 12:23:04
21953,Meudon,1,0,1,19,1,2023-05-31 12:23:04
21954,Meudon,6,1,7,15,1,2023-05-31 12:23:05
21952,Meudon,2,2,4,38,1,2023-05-31 12:33:08
21951,Meudon,3,1,4,18,1,2023-05-31 12:33:08
21953,Meudon,0,0,0,20,1,2023-05-31 12:33:08
21954,Meudon,5,1,6,16,1,2023-05-31 12:33:09
21952,Meudon,4,1,5,37,1,2023-05-31 12:43:11
21951,Meudon,3,1,4,18,1,2023-05-31 12:43:11
21953,Meudon,0,0,0,20,1,2023-05-31 12:43:12
21954,Meudon,5,1,6,16,1,2023-05-31 12:43:12
21952,Meudon,4,1,5,37,1,2023-05-31 12:53:15
21951,Meudon,3,1,4,18,1,2023-05-31 12:53:15
21953,Meudon,0,0,0,20,1,2023-05-31 12:53:16
21954,Meudon,6,1,7,15,1,2023-05-31 12:53:16
21952,Meudon,4,1,5,37,1,2023-05-31 20:13:05
21951,Meudon,2,0,2,20,1,2023-05-31 20:13:05
21953,Meudon,1,0,1,19,1,2023-05-31 20:13:05
21954,Meudon,0,3,3,20,1,2023-05-31 20:13:05
21952,Meudon,4,1,5,37,1,2023-05-31 20:23:08
21951,Meudon,2,0,2,20,1,2023-05-31 20:23:08
21953,Meudon,1,0,1,19,1,2023-05-31 20:23:08
21954,Meudon,0,3,3,20,1,2023-05-31 20:23:08
21952,Meudon,4,1,5,37,1,2023-05-31 20:33:11
21951,Meudon,2,0,2,20,1,2023-05-31 20:33:11
21953,Meudon,1,0,1,19,1,2023-05-31 20:33:12
21954,Meudon,0,3,3,20,1,2023-05-31 20:33:12
21952,Meudon,4,1,5,37,1,2023-05-31 20:43:15
21951,Meudon,2,0,2,20,1,2023-05-31 20:43:15
21953,Meudon,1,0,1,19,1,2023-05-31 20:43:15
21954,Meudon,0,3,3,20,1,2023-05-31 20:43:15
21952,Meudon,4,1,5,37,1,2023-05-31 20:53:24
21951,Meudon,2,0,2,20,1,2023-05-31 20:53:24
21953,Meudon,1,0,1,19,1,2023-05-31 20:53:24
21954,Meudon,0,3,3,20,1,2023-05-31 20:53:24
21952,Meudon,4,1,5,37,1,2023-05-31 21:03:26
21951,Meudon,2,0,2,20,1,2023-05-31 21:03:26
21953,Meudon,1,0,1,19,1,2023-05-31 21:03:26
21954,Meudon,0,3,3,20,1,2023-05-31 21:03:26
21952,Meudon,2,2,4,38,1,2023-06-01 11:01:53
21951,Meudon,4,1,5,17,1,2023-06-01 11:01:53
21953,Meudon,0,0,0,20,1,2023-06-01 11:01:53
21954,Meudon,1,2,3,20,1,2023-06-01 11:01:53
21952,Meudon,2,2,4,38,1,2023-06-01 11:11:55
21951,Meudon,4,1,5,17,1,2023-06-01 11:11:56
21953,Meudon,0,0,0,20,1,2023-06-01 11:11:56
21954,Meudon,1,2,3,20,1,2023-06-01 11:11:56
21952,Meudon,2,2,4,38,1,2023-06-01 11:21:59
21951,Meudon,4,1,5,17,1,2023-06-01 11:21:59
21953,Meudon,0,0,0,20,1,2023-06-01 11:21:59
21954,Meudon,1,2,3,20,1,2023-06-01 11:21:59
21952,Meudon,2,2,4,38,1,2023-06-01 11:32:02
21951,Meudon,4,1,5,17,1,2023-06-01 11:32:02
21953,Meudon,0,0,0,20,1,2023-06-01 11:32:02
21954,Meudon,2,2,4,19,1,2023-06-01 11:32:02
21952,Meudon,2,2,4,38,1,2023-06-01 11:42:06
21951,Meudon,4,1,5,17,1,2023-06-01 11:42:06
21953,Meudon,0,0,0,20,1,2023-06-01 11:42:06
21954,Meudon,2,2,4,19,1,2023-06-01 11:42:07
21952,Meudon,2,2,4,38,1,2023-06-01 11:52:10
21951,Meudon,4,1,5,17,1,2023-06-01 11:52:10
21953,Meudon,0,0,0,20,1,2023-06-01 11:52:10
21954,Meudon,2,2,4,19,1,2023-06-01 11:52:11
21952,Meudon,2,2,4,38,1,2023-06-01 12:02:12
21951,Meudon,4,1,5,17,1,2023-06-01 12:02:12
21953,Meudon,0,0,0,20,1,2023-06-01 12:02:13
21954,Meudon,2,2,4,19,1,2023-06-01 12:02:13
21952,Meudon,2,1,3,39,1,2023-06-01 12:12:15
21951,Meudon,4,1,5,17,1,2023-06-01 12:12:15
21953,Meudon,0,0,0,20,1,2023-06-01 12:12:16
21954,Meudon,2,2,4,19,1,2023-06-01 12:12:16
21952,Meudon,2,2,4,38,1,2023-06-01 12:22:20
21951,Meudon,4,1,5,17,1,2023-06-01 12:22:20
21953,Meudon,0,0,0,20,1,2023-06-01 12:22:20
21954,Meudon,2,2,4,19,1,2023-06-01 12:22:21
21952,Meudon,2,3,5,37,1,2023-06-01 12:32:22
21951,Meudon,4,1,5,17,1,2023-06-01 12:32:23
21953,Meudon,0,0,0,20,1,2023-06-01 12:32:23
21954,Meudon,1,2,3,20,1,2023-06-01 12:32:24
21952,Meudon,2,4,6,36,1,2023-06-01 12:42:26
21951,Meudon,4,1,5,17,1,2023-06-01 12:42:26
21953,Meudon,1,0,1,19,1,2023-06-01 12:42:26
21954,Meudon,0,2,2,21,1,2023-06-01 12:42:26
21952,Meudon,2,4,6,36,1,2023-06-01 12:52:28
21951,Meudon,4,1,5,17,1,2023-06-01 12:52:28
21953,Meudon,1,0,1,19,1,2023-06-01 12:52:29
21954,Meudon,0,1,1,22,1,2023-06-01 12:52:29
21952,Meudon,2,5,7,35,1,2023-06-02 11:20:15
21951,Meudon,2,1,3,19,1,2023-06-02 11:20:16
21953,Meudon,4,0,4,16,1,2023-06-02 11:20:16
21954,Meudon,2,4,6,17,1,2023-06-02 11:20:17
21952,Meudon,2,5,7,35,1,2023-06-02 11:30:18
21951,Meudon,1,0,1,21,1,2023-06-02 11:30:18
21953,Meudon,4,0,4,16,1,2023-06-02 11:30:19
21954,Meudon,2,4,6,17,1,2023-06-02 11:30:19
21952,Meudon,2,5,7,34,1,2023-06-02 11:40:21
21951,Meudon,1,0,1,21,1,2023-06-02 11:40:21
21953,Meudon,4,0,4,16,1,2023-06-02 11:40:21
21954,Meudon,2,4,6,17,1,2023-06-02 11:40:22
21952,Meudon,2,5,7,34,1,2023-06-02 11:50:25
21951,Meudon,1,0,1,21,1,2023-06-02 11:50:25
21953,Meudon,3,0,3,17,1,2023-06-02 11:50:25
21954,Meudon,2,4,6,17,1,2023-06-02 11:50:25
21952,Meudon,2,4,6,35,1,2023-06-02 12:00:28
21951,Meudon,1,0,1,21,1,2023-06-02 12:00:28
21953,Meudon,3,0,3,17,1,2023-06-02 12:00:28
21954,Meudon,2,4,6,17,1,2023-06-02 12:00:29
21952,Meudon,2,4,6,35,1,2023-06-02 12:10:31
21951,Meudon,1,0,1,21,1,2023-06-02 12:10:31
21953,Meudon,4,0,4,16,1,2023-06-02 12:10:32
21954,Meudon,2,4,6,17,1,2023-06-02 12:10:32
21952,Meudon,3,4,7,34,1,2023-06-02 12:20:34
21951,Meudon,1,0,1,21,1,2023-06-02 12:20:34
21953,Meudon,3,0,3,17,1,2023-06-02 12:20:34
21954,Meudon,1,4,5,18,1,2023-06-02 12:20:34
21952,Meudon,2,5,7,34,1,2023-06-02 13:40:44
21951,Meudon,1,0,1,21,1,2023-06-02 13:40:44
21953,Meudon,3,0,3,17,1,2023-06-02 13:40:44
21954,Meudon,1,3,4,19,1,2023-06-02 13:40:44
21952,Meudon,3,5,8,33,1,2023-06-02 13:50:46
21951,Meudon,1,0,1,21,1,2023-06-02 13:50:46
21953,Meudon,2,0,2,18,1,2023-06-02 13:50:47
21954,Meudon,1,3,4,19,1,2023-06-02 13:50:47
21952,Meudon,4,5,9,32,1,2023-06-02 14:00:49
21951,Meudon,1,0,1,21,1,2023-06-02 14:00:49
21953,Meudon,2,0,2,18,1,2023-06-02 14:00:49
21954,Meudon,1,3,4,19,1,2023-06-02 14:00:49
21952,Meudon,4,5,9,32,1,2023-06-02 14:10:52
21951,Meudon,1,0,1,21,1,2023-06-02 14:10:52
21953,Meudon,3,0,3,17,1,2023-06-02 14:10:52
21954,Meudon,0,3,3,20,1,2023-06-02 14:10:52
21952,Meudon,4,5,9,32,1,2023-06-02 14:20:55
21951,Meudon,1,0,1,21,1,2023-06-02 14:20:55
21953,Meudon,3,0,3,17,1,2023-06-02 14:20:55
21954,Meudon,0,2,2,21,1,2023-06-02 14:20:56
21952,Meudon,4,5,9,32,1,2023-06-02 14:30:58
21951,Meudon,1,0,1,21,1,2023-06-02 14:30:58
21953,Meudon,3,0,3,17,1,2023-06-02 14:30:58
21954,Meudon,0,2,2,21,1,2023-06-02 14:30:58
21952,Meudon,4,5,9,32,1,2023-06-02 14:41:00
21951,Meudon,1,0,1,21,1,2023-06-02 14:41:00
21953,Meudon,3,0,3,17,1,2023-06-02 14:41:01
21954,Meudon,0,2,2,21,1,2023-06-02 14:41:01
21952,Meudon,4,5,9,32,1,2023-06-02 14:51:03
21951,Meudon,1,0,1,21,1,2023-06-02 14:51:03
21953,Meudon,3,0,3,17,1,2023-06-02 14:51:03
21954,Meudon,0,2,2,21,1,2023-06-02 14:51:04
21952,Meudon,4,5,9,32,1,2023-06-02 15:01:05
21951,Meudon,1,0,1,21,1,2023-06-02 15:01:05
21953,Meudon,3,0,3,17,1,2023-06-02 15:01:05
21954,Meudon,0,2,2,21,1,2023-06-02 15:01:06
21952,Meudon,4,5,9,32,1,2023-06-02 15:11:08
21951,Meudon,1,0,1,21,1,2023-06-02 15:11:08
21953,Meudon,3,0,3,17,1,2023-06-02 15:11:09
21954,Meudon,0,2,2,21,1,2023-06-02 15:11:09
21952,Meudon,4,5,9,32,1,2023-06-02 17:07:25
21951,Meudon,1,0,1,21,1,2023-06-02 17:07:25
21953,Meudon,3,0,3,17,1,2023-06-02 17:07:25
21954,Meudon,0,2,2,21,1,2023-06-02 17:07:25
21952,Meudon,4,5,9,32,1,2023-06-02 17:17:28
21951,Meudon,1,0,1,21,1,2023-06-02 17:17:28
21953,Meudon,3,0,3,17,1,2023-06-02 17:17:28
21954,Meudon,0,2,2,21,1,2023-06-02 17:17:28
21952,Meudon,4,5,9,32,1,2023-06-02 17:27:30
21951,Meudon,1,0,1,21,1,2023-06-02 17:27:30
21953,Meudon,3,0,3,17,1,2023-06-02 17:27:30
21954,Meudon,0,2,2,21,1,2023-06-02 17:27:30
21952,Meudon,4,5,9,32,1,2023-06-02 17:37:32
21951,Meudon,1,0,1,21,1,2023-06-02 17:37:32
21953,Meudon,3,0,3,17,1,2023-06-02 17:37:32
21954,Meudon,0,2,2,21,1,2023-06-02 17:37:32
21952,Meudon,4,5,9,32,1,2023-06-02 17:47:34
21951,Meudon,1,0,1,21,1,2023-06-02 17:47:34
21953,Meudon,3,0,3,17,1,2023-06-02 17:47:34
21954,Meudon,0,2,2,21,1,2023-06-02 17:47:34
21952,Meudon,4,5,9,32,1,2023-06-02 17:57:35
21951,Meudon,1,0,1,21,1,2023-06-02 17:57:36
21953,Meudon,3,0,3,17,1,2023-06-02 17:57:36
21954,Meudon,0,2,2,21,1,2023-06-02 17:57:36
21952,Meudon,4,5,9,32,1,2023-06-02 18:07:37
21951,Meudon,1,0,1,21,1,2023-06-02 18:07:37
21953,Meudon,3,0,3,17,1,2023-06-02 18:07:37
21954,Meudon,0,2,2,21,1,2023-06-02 18:07:38
21952,Meudon,4,5,9,32,1,2023-06-02 18:17:40
21951,Meudon,1,0,1,21,1,2023-06-02 18:17:40
21953,Meudon,3,0,3,17,1,2023-06-02 18:17:40
21954,Meudon,0,2,2,21,1,2023-06-02 18:17:40
21952,Meudon,4,5,9,32,1,2023-06-02 18:27:42
21951,Meudon,1,0,1,21,1,2023-06-02 18:27:42
21953,Meudon,3,0,3,17,1,2023-06-02 18:27:42
21954,Meudon,0,2,2,21,1,2023-06-02 18:27:43
21952,Meudon,4,5,9,32,1,2023-06-02 18:37:44
21951,Meudon,1,0,1,21,1,2023-06-02 18:37:44
21953,Meudon,3,0,3,17,1,2023-06-02 18:37:44
21954,Meudon,0,2,2,21,1,2023-06-02 18:37:44
21952,Meudon,4,5,9,32,1,2023-06-02 18:47:46
21951,Meudon,1,0,1,21,1,2023-06-02 18:47:46
21953,Meudon,3,0,3,17,1,2023-06-02 18:47:46
21954,Meudon,0,2,2,21,1,2023-06-02 18:47:46
21952,Meudon,4,5,9,32,1,2023-06-02 18:57:48
21951,Meudon,1,0,1,21,1,2023-06-02 18:57:48
21953,Meudon,3,0,3,17,1,2023-06-02 18:57:48
21954,Meudon,0,2,2,21,1,2023-06-02 18:57:49
21952,Meudon,4,5,9,32,1,2023-06-02 19:07:50
21951,Meudon,1,0,1,21,1,2023-06-02 19:07:50
21953,Meudon,3,0,3,17,1,2023-06-02 19:07:51
21954,Meudon,0,2,2,21,1,2023-06-02 19:07:51
21952,Meudon,4,5,9,32,1,2023-06-02 19:17:52
21951,Meudon,1,0,1,21,1,2023-06-02 19:17:52
21953,Meudon,3,0,3,17,1,2023-06-02 19:17:53
21954,Meudon,0,2,2,21,1,2023-06-02 19:17:53
21952,Meudon,4,5,9,32,1,2023-06-02 19:27:56
21951,Meudon,1,0,1,21,1,2023-06-02 19:27:56
21953,Meudon,3,0,3,17,1,2023-06-02 19:27:56
21954,Meudon,0,2,2,21,1,2023-06-02 19:27:56
21952,Meudon,4,5,9,32,1,2023-06-02 19:37:58
21951,Meudon,1,0,1,21,1,2023-06-02 19:37:58
21953,Meudon,3,0,3,17,1,2023-06-02 19:37:58
21954,Meudon,0,2,2,21,1,2023-06-02 19:37:58
21952,Meudon,4,5,9,32,1,2023-06-02 19:48:00
21951,Meudon,1,0,1,21,1,2023-06-02 19:48:00
21953,Meudon,3,0,3,17,1,2023-06-02 19:48:00
21954,Meudon,0,2,2,21,1,2023-06-02 19:48:00
21952,Meudon,4,5,9,32,1,2023-06-02 19:58:02
21951,Meudon,1,0,1,21,1,2023-06-02 19:58:02
21953,Meudon,3,0,3,17,1,2023-06-02 19:58:02
21954,Meudon,0,2,2,21,1,2023-06-02 19:58:03
21952,Meudon,4,5,9,32,1,2023-06-02 20:08:04
21951,Meudon,1,0,1,21,1,2023-06-02 20:08:04
21953,Meudon,3,0,3,17,1,2023-06-02 20:08:04
21954,Meudon,0,2,2,21,1,2023-06-02 20:08:05
21952,Meudon,4,5,9,32,1,2023-06-02 20:18:06
21951,Meudon,1,0,1,21,1,2023-06-02 20:18:06
21953,Meudon,3,0,3,17,1,2023-06-02 20:18:07
21954,Meudon,0,2,2,21,1,2023-06-02 20:18:07
21952,Meudon,4,5,9,32,1,2023-06-02 20:28:09
21951,Meudon,1,0,1,21,1,2023-06-02 20:28:09
21953,Meudon,3,0,3,17,1,2023-06-02 20:28:09
21954,Meudon,0,2,2,21,1,2023-06-02 20:28:09
21952,Meudon,4,5,9,32,1,2023-06-02 20:38:11
21951,Meudon,1,0,1,21,1,2023-06-02 20:38:11
21953,Meudon,3,0,3,17,1,2023-06-02 20:38:11
21954,Meudon,0,2,2,21,1,2023-06-02 20:38:11
21952,Meudon,4,5,9,32,1,2023-06-02 20:48:13
21951,Meudon,1,0,1,21,1,2023-06-02 20:48:13
21953,Meudon,3,0,3,17,1,2023-06-02 20:48:13
21954,Meudon,0,2,2,21,1,2023-06-02 20:48:14
21952,Meudon,4,5,9,32,1,2023-06-02 20:58:16
21951,Meudon,1,0,1,21,1,2023-06-02 20:58:16
21953,Meudon,3,0,3,17,1,2023-06-02 20:58:16
21954,Meudon,0,2,2,21,1,2023-06-02 20:58:16
21952,Meudon,4,5,9,32,1,2023-06-02 21:08:19
21951,Meudon,1,0,1,21,1,2023-06-02 21:08:19
21953,Meudon,3,0,3,17,1,2023-06-02 21:08:19
21954,Meudon,0,2,2,21,1,2023-06-02 21:08:20
21952,Meudon,7,24,31,11,1,2023-06-03 09:01:23
21951,Meudon,3,0,3,19,1,2023-06-03 09:01:23
21953,Meudon,6,2,8,12,1,2023-06-03 09:01:23
21954,Meudon,11,0,11,12,1,2023-06-03 09:01:23
21952,Meudon,7,24,31,11,1,2023-06-03 09:11:24
21951,Meudon,3,0,3,19,1,2023-06-03 09:11:24
21953,Meudon,6,2,8,12,1,2023-06-03 09:11:24
21954,Meudon,11,0,11,12,1,2023-06-03 09:11:24
21952,Meudon,8,24,32,10,1,2023-06-03 09:21:26
21951,Meudon,3,0,3,19,1,2023-06-03 09:21:26
21953,Meudon,6,2,8,12,1,2023-06-03 09:21:26
21954,Meudon,10,1,11,12,1,2023-06-03 09:21:26
21952,Meudon,8,24,32,10,1,2023-06-03 09:31:28
21951,Meudon,3,0,3,19,1,2023-06-03 09:31:28
21953,Meudon,6,2,8,12,1,2023-06-03 09:31:28
21954,Meudon,10,1,11,12,1,2023-06-03 09:31:28
21952,Meudon,9,24,33,9,1,2023-06-03 09:41:29
21951,Meudon,3,0,3,19,1,2023-06-03 09:41:29
21953,Meudon,5,2,7,13,1,2023-06-03 09:41:29
21954,Meudon,10,1,11,12,1,2023-06-03 09:41:29
21952,Meudon,9,24,33,9,1,2023-06-03 09:51:31
21951,Meudon,3,0,3,19,1,2023-06-03 09:51:31
21953,Meudon,5,2,7,13,1,2023-06-03 09:51:31
21954,Meudon,10,1,11,12,1,2023-06-03 09:51:31
21952,Meudon,9,24,33,9,1,2023-06-03 10:01:33
21951,Meudon,3,0,3,19,1,2023-06-03 10:01:33
21953,Meudon,5,2,7,13,1,2023-06-03 10:01:34
21954,Meudon,10,1,11,12,1,2023-06-03 10:01:34
21952,Meudon,9,25,34,8,1,2023-06-03 10:11:36
21951,Meudon,3,0,3,19,1,2023-06-03 10:11:36
21953,Meudon,5,2,7,13,1,2023-06-03 10:11:36
21954,Meudon,9,1,10,13,1,2023-06-03 10:11:36
21952,Meudon,9,25,34,8,1,2023-06-03 10:21:37
21951,Meudon,3,0,3,19,1,2023-06-03 10:21:37
21953,Meudon,5,2,7,13,1,2023-06-03 10:21:37
21954,Meudon,9,1,10,13,1,2023-06-03 10:21:38
21952,Meudon,8,25,33,9,1,2023-06-03 10:31:40
21951,Meudon,3,0,3,19,1,2023-06-03 10:31:40
21953,Meudon,6,2,8,12,1,2023-06-03 10:31:40
21954,Meudon,8,1,9,14,1,2023-06-03 10:31:40
21952,Meudon,7,24,31,10,1,2023-06-03 10:41:42
21951,Meudon,3,0,3,19,1,2023-06-03 10:41:42
21953,Meudon,6,2,8,12,1,2023-06-03 10:41:42
21954,Meudon,8,1,9,14,1,2023-06-03 10:41:42
21952,Meudon,6,24,30,11,1,2023-06-03 10:51:44
21951,Meudon,3,0,3,19,1,2023-06-03 10:51:44
21953,Meudon,6,1,7,13,1,2023-06-03 10:51:44
21954,Meudon,7,1,8,15,1,2023-06-03 10:51:44
21952,Meudon,6,24,30,11,1,2023-06-03 11:01:47
21951,Meudon,3,0,3,19,1,2023-06-03 11:01:47
21953,Meudon,6,1,7,13,1,2023-06-03 11:01:47
21954,Meudon,6,2,8,15,1,2023-06-03 11:01:47
21951,Meudon,3,0,3,19,1,2023-06-03 11:11:49
21952,Meudon,6,24,30,11,1,2023-06-03 11:11:49
21953,Meudon,6,1,7,13,1,2023-06-03 11:11:49
21954,Meudon,6,2,8,15,1,2023-06-03 11:11:49
21951,Meudon,3,0,3,19,1,2023-06-03 11:21:51
21952,Meudon,6,23,29,12,1,2023-06-03 11:21:51
21953,Meudon,7,1,8,12,1,2023-06-03 11:21:52
21954,Meudon,5,2,7,16,1,2023-06-03 11:21:52
21951,Meudon,3,0,3,19,1,2023-06-03 11:31:54
21952,Meudon,6,24,30,11,1,2023-06-03 11:31:54
21953,Meudon,8,1,9,11,1,2023-06-03 11:31:54
21954,Meudon,5,1,6,17,1,2023-06-03 11:31:54
21952,Meudon,6,24,30,11,1,2023-06-03 11:41:56
21951,Meudon,1,0,1,21,1,2023-06-03 11:41:56
21953,Meudon,8,1,9,11,1,2023-06-03 11:41:56
21954,Meudon,6,1,7,16,1,2023-06-03 11:41:56
21952,Meudon,6,24,30,11,1,2023-06-03 11:52:00
21951,Meudon,1,0,1,21,1,2023-06-03 11:52:00
21953,Meudon,8,1,9,11,1,2023-06-03 11:52:01
21954,Meudon,6,1,7,16,1,2023-06-03 11:52:01
21952,Meudon,5,24,29,12,1,2023-06-03 12:02:03
21951,Meudon,2,0,2,20,1,2023-06-03 12:02:03
21953,Meudon,7,1,8,12,1,2023-06-03 12:02:04
21954,Meudon,5,0,5,18,1,2023-06-03 12:02:04
21952,Meudon,5,24,29,12,1,2023-06-03 12:12:09
21951,Meudon,1,0,1,21,1,2023-06-03 12:12:09
21953,Meudon,6,1,7,13,1,2023-06-03 12:12:09
21954,Meudon,6,0,6,17,1,2023-06-03 12:12:10
21952,Meudon,6,24,30,11,1,2023-06-03 12:22:12
21951,Meudon,1,0,1,21,1,2023-06-03 12:22:12
21953,Meudon,5,0,5,15,1,2023-06-03 12:22:12
21954,Meudon,8,0,8,15,1,2023-06-03 12:22:13
21952,Meudon,7,24,31,10,1,2023-06-03 12:32:15
21951,Meudon,1,0,1,21,1,2023-06-03 12:32:15
21953,Meudon,5,0,5,15,1,2023-06-03 12:32:15
21954,Meudon,7,0,7,16,1,2023-06-03 12:32:16
21952,Meudon,6,24,30,11,1,2023-06-03 12:42:21
21951,Meudon,1,0,1,21,1,2023-06-03 12:42:21
21953,Meudon,5,0,5,15,1,2023-06-03 12:42:21
21954,Meudon,7,0,7,16,1,2023-06-03 12:42:22
21952,Meudon,7,24,31,10,1,2023-06-03 12:52:25
21951,Meudon,1,0,1,21,1,2023-06-03 12:52:25
21953,Meudon,3,0,3,17,1,2023-06-03 12:52:25
21954,Meudon,7,0,7,16,1,2023-06-03 12:52:26
21952,Meudon,6,24,30,11,1,2023-06-03 13:02:29
21951,Meudon,1,0,1,21,1,2023-06-03 13:02:29
21953,Meudon,3,0,3,17,1,2023-06-03 13:02:29
21954,Meudon,7,0,7,16,1,2023-06-03 13:02:29
21952,Meudon,6,25,31,10,1,2023-06-03 13:12:32
21951,Meudon,1,0,1,21,1,2023-06-03 13:12:32
21953,Meudon,2,1,3,17,1,2023-06-03 13:12:33
21954,Meudon,7,0,7,16,1,2023-06-03 13:12:33
21952,Meudon,4,24,28,13,1,2023-06-03 13:22:37
21951,Meudon,1,0,1,21,1,2023-06-03 13:22:37
21953,Meudon,2,1,3,17,1,2023-06-03 13:22:37
21954,Meudon,7,0,7,16,1,2023-06-03 13:22:38
21952,Meudon,4,23,27,14,1,2023-06-03 13:32:40
21951,Meudon,1,0,1,21,1,2023-06-03 13:32:40
21953,Meudon,3,1,4,16,1,2023-06-03 13:32:40
21954,Meudon,7,0,7,16,1,2023-06-03 13:32:41
21952,Meudon,5,23,28,13,1,2023-06-03 13:42:43
21951,Meudon,1,0,1,21,1,2023-06-03 13:42:43
21953,Meudon,3,0,3,17,1,2023-06-03 13:42:44
21954,Meudon,7,0,7,16,1,2023-06-03 13:42:44
21951,Meudon,1,0,1,21,1,2023-06-03 13:52:47
21952,Meudon,6,22,28,13,1,2023-06-03 13:52:47
21953,Meudon,3,0,3,17,1,2023-06-03 13:52:47
21954,Meudon,4,0,4,19,1,2023-06-03 13:52:47
21952,Meudon,5,22,27,14,1,2023-06-03 14:02:50
21951,Meudon,1,0,1,21,1,2023-06-03 14:02:50
21953,Meudon,2,0,2,18,1,2023-06-03 14:02:51
21954,Meudon,4,0,4,19,1,2023-06-03 14:02:51
21952,Meudon,5,23,28,13,1,2023-06-03 14:12:55
21951,Meudon,1,0,1,21,1,2023-06-03 14:12:55
21953,Meudon,2,0,2,18,1,2023-06-03 14:12:55
21954,Meudon,4,1,5,18,1,2023-06-03 14:12:56
21952,Meudon,4,23,27,14,1,2023-06-03 14:22:58
21951,Meudon,1,0,1,21,1,2023-06-03 14:22:58
21953,Meudon,3,0,3,17,1,2023-06-03 14:22:59
21954,Meudon,4,0,4,19,1,2023-06-03 14:22:59
21951,Meudon,1,0,1,21,1,2023-06-03 14:33:02
21952,Meudon,4,21,25,16,1,2023-06-03 14:33:02
21953,Meudon,3,0,3,17,1,2023-06-03 14:33:02
21954,Meudon,4,0,4,19,1,2023-06-03 14:33:03
21952,Meudon,3,20,23,18,1,2023-06-03 14:43:05
21951,Meudon,1,0,1,21,1,2023-06-03 14:43:05
21953,Meudon,3,0,3,17,1,2023-06-03 14:43:06
21954,Meudon,3,0,3,20,1,2023-06-03 14:43:06
21952,Meudon,2,20,22,19,1,2023-06-03 14:53:09
21951,Meudon,1,0,1,21,1,2023-06-03 14:53:09
21953,Meudon,3,0,3,17,1,2023-06-03 14:53:09
21954,Meudon,3,0,3,20,1,2023-06-03 14:53:09
21952,Meudon,1,20,21,20,1,2023-06-03 15:03:11
21951,Meudon,1,0,1,21,1,2023-06-03 15:03:11
21953,Meudon,3,0,3,17,1,2023-06-03 15:03:11
21954,Meudon,3,0,3,20,1,2023-06-03 15:03:12
21952,Meudon,1,20,21,20,1,2023-06-03 15:13:14
21951,Meudon,1,0,1,21,1,2023-06-03 15:13:14
21953,Meudon,2,0,2,18,1,2023-06-03 15:13:14
21954,Meudon,3,1,4,19,1,2023-06-03 15:13:14
21952,Meudon,1,19,20,21,1,2023-06-03 15:23:17
21951,Meudon,1,0,1,21,1,2023-06-03 15:23:17
21953,Meudon,2,0,2,18,1,2023-06-03 15:23:17
21954,Meudon,3,1,4,19,1,2023-06-03 15:23:17
21952,Meudon,2,19,21,20,1,2023-06-03 15:33:19
21951,Meudon,1,0,1,21,1,2023-06-03 15:33:19
21953,Meudon,3,0,3,17,1,2023-06-03 15:33:19
21954,Meudon,1,0,1,22,1,2023-06-03 15:33:19
21951,Meudon,1,0,1,21,1,2023-06-03 15:43:22
21952,Meudon,0,19,19,22,1,2023-06-03 15:43:22
21953,Meudon,3,0,3,17,1,2023-06-03 15:43:22
21954,Meudon,1,0,1,22,1,2023-06-03 15:43:22
21952,Meudon,2,21,23,18,1,2023-06-03 15:53:24
21951,Meudon,1,0,1,21,1,2023-06-03 15:53:25
21953,Meudon,2,0,2,18,1,2023-06-03 15:53:25
21954,Meudon,0,0,0,22,1,2023-06-03 15:53:25
21951,Meudon,1,0,1,21,1,2023-06-03 16:03:27
21952,Meudon,1,21,22,19,1,2023-06-03 16:03:27
21953,Meudon,2,0,2,18,1,2023-06-03 16:03:27
21954,Meudon,2,0,2,20,1,2023-06-03 16:03:27
21952,Meudon,3,21,24,17,1,2023-06-03 16:13:36
21951,Meudon,1,0,1,21,1,2023-06-03 16:13:36
21953,Meudon,2,0,2,18,1,2023-06-03 16:13:36
21954,Meudon,2,0,2,20,1,2023-06-03 16:13:36
21952,Meudon,4,20,24,17,1,2023-06-03 16:23:39
21951,Meudon,1,0,1,21,1,2023-06-03 16:23:39
21953,Meudon,2,0,2,18,1,2023-06-03 16:23:39
21954,Meudon,3,0,3,19,1,2023-06-03 16:23:39
21952,Meudon,4,20,24,17,1,2023-06-03 16:33:44
21951,Meudon,1,0,1,21,1,2023-06-03 16:33:44
21953,Meudon,2,0,2,18,1,2023-06-03 16:33:44
21954,Meudon,4,0,4,18,1,2023-06-03 16:33:45
21952,Meudon,5,22,27,14,1,2023-06-03 16:43:46
21951,Meudon,1,0,1,21,1,2023-06-03 16:43:46
21953,Meudon,2,0,2,18,1,2023-06-03 16:43:46
21954,Meudon,5,1,6,16,1,2023-06-03 16:43:47
21951,Meudon,1,0,1,21,1,2023-06-03 16:53:49
21952,Meudon,5,22,27,14,1,2023-06-03 16:53:49
21953,Meudon,1,0,1,19,1,2023-06-03 16:53:49
21954,Meudon,6,1,7,15,1,2023-06-03 16:53:49
21952,Meudon,4,22,26,15,1,2023-06-03 17:03:51
21951,Meudon,1,0,1,21,1,2023-06-03 17:03:51
21953,Meudon,2,0,2,18,1,2023-06-03 17:03:51
21954,Meudon,6,1,7,15,1,2023-06-03 17:03:51
21952,Meudon,5,24,29,12,1,2023-06-03 17:13:54
21951,Meudon,1,0,1,21,1,2023-06-03 17:13:54
21953,Meudon,2,0,2,18,1,2023-06-03 17:13:54
21954,Meudon,6,1,7,15,1,2023-06-03 17:13:54
21952,Meudon,4,24,28,13,1,2023-06-03 17:23:56
21951,Meudon,1,0,1,21,1,2023-06-03 17:23:56
21953,Meudon,0,0,0,20,1,2023-06-03 17:23:56
21954,Meudon,7,1,8,14,1,2023-06-03 17:23:56
21952,Meudon,1,22,23,18,1,2023-06-03 17:33:59
21951,Meudon,1,0,1,21,1,2023-06-03 17:33:59
21953,Meudon,0,0,0,20,1,2023-06-03 17:33:59
21954,Meudon,7,1,8,14,1,2023-06-03 17:33:59
21952,Meudon,1,22,23,18,1,2023-06-03 17:44:21
21951,Meudon,1,0,1,21,1,2023-06-03 17:44:21
21953,Meudon,0,0,0,20,1,2023-06-03 17:44:21
21954,Meudon,8,1,9,13,1,2023-06-03 17:44:22
21952,Meudon,1,24,25,15,1,2023-06-03 17:54:25
21951,Meudon,1,0,1,21,1,2023-06-03 17:54:25
21953,Meudon,1,0,1,19,1,2023-06-03 17:54:25
21954,Meudon,8,2,10,12,1,2023-06-03 17:54:25
21952,Meudon,1,24,25,15,1,2023-06-03 18:04:28
21951,Meudon,1,0,1,21,1,2023-06-03 18:04:28
21953,Meudon,1,0,1,19,1,2023-06-03 18:04:28
21954,Meudon,8,2,10,12,1,2023-06-03 18:04:28
21952,Meudon,1,24,25,15,1,2023-06-03 18:14:32
21951,Meudon,1,0,1,21,1,2023-06-03 18:14:32
21953,Meudon,1,0,1,19,1,2023-06-03 18:14:32
21954,Meudon,10,2,12,10,1,2023-06-03 18:14:33
21952,Meudon,2,24,26,14,1,2023-06-03 18:24:36
21951,Meudon,1,0,1,21,1,2023-06-03 18:24:36
21953,Meudon,2,0,2,18,1,2023-06-03 18:24:36
21954,Meudon,10,2,12,10,1,2023-06-03 18:24:37
21952,Meudon,2,24,26,14,1,2023-06-03 18:34:39
21951,Meudon,1,0,1,21,1,2023-06-03 18:34:39
21953,Meudon,1,0,1,19,1,2023-06-03 18:34:39
21954,Meudon,10,2,12,10,1,2023-06-03 18:34:40
21952,Meudon,1,25,26,14,1,2023-06-03 18:44:43
21951,Meudon,1,0,1,21,1,2023-06-03 18:44:43
21953,Meudon,0,0,0,20,1,2023-06-03 18:44:44
21954,Meudon,10,2,12,10,1,2023-06-03 18:44:44
21952,Meudon,1,24,25,15,1,2023-06-03 18:54:47
21951,Meudon,1,0,1,21,1,2023-06-03 18:54:47
21953,Meudon,0,0,0,20,1,2023-06-03 18:54:47
21954,Meudon,10,2,12,10,1,2023-06-03 18:54:48
21952,Meudon,3,24,27,13,1,2023-06-03 19:04:51
21951,Meudon,1,0,1,21,1,2023-06-03 19:04:51
21953,Meudon,0,0,0,20,1,2023-06-03 19:04:51
21954,Meudon,10,2,12,10,1,2023-06-03 19:04:52
21952,Meudon,3,24,27,13,1,2023-06-03 19:14:55
21951,Meudon,1,0,1,21,1,2023-06-03 19:14:55
21953,Meudon,0,0,0,20,1,2023-06-03 19:14:55
21954,Meudon,13,1,14,8,1,2023-06-03 19:14:56
21952,Meudon,1,25,26,14,1,2023-06-03 19:24:58
21951,Meudon,1,0,1,21,1,2023-06-03 19:24:58
21953,Meudon,2,0,2,18,1,2023-06-03 19:24:59
21954,Meudon,13,1,14,8,1,2023-06-03 19:24:59
21952,Meudon,0,23,23,17,1,2023-06-03 19:35:04
21951,Meudon,1,0,1,21,1,2023-06-03 19:35:04
21953,Meudon,2,0,2,18,1,2023-06-03 19:35:04
21954,Meudon,14,2,16,6,1,2023-06-03 19:35:04
21952,Meudon,0,21,21,19,1,2023-06-03 19:45:07
21951,Meudon,1,0,1,21,1,2023-06-03 19:45:07
21953,Meudon,0,0,0,20,1,2023-06-03 19:45:08
21954,Meudon,12,2,14,8,1,2023-06-03 19:45:08
21952,Meudon,0,21,21,19,1,2023-06-03 19:55:12
21951,Meudon,1,0,1,21,1,2023-06-03 19:55:12
21953,Meudon,0,0,0,20,1,2023-06-03 19:55:12
21954,Meudon,14,3,17,5,1,2023-06-03 19:55:13
21952,Meudon,1,20,21,19,1,2023-06-03 20:05:16
21951,Meudon,1,0,1,21,1,2023-06-03 20:05:16
21953,Meudon,0,0,0,20,1,2023-06-03 20:05:16
21954,Meudon,16,3,19,3,1,2023-06-03 20:05:17
21952,Meudon,2,23,25,15,1,2023-06-03 20:15:21
21951,Meudon,1,0,1,21,1,2023-06-03 20:15:21
21953,Meudon,1,1,2,18,1,2023-06-03 20:15:21
21954,Meudon,16,3,19,3,1,2023-06-03 20:15:21
21952,Meudon,1,23,24,16,1,2023-06-03 20:25:24
21951,Meudon,1,0,1,21,1,2023-06-03 20:25:24
21953,Meudon,0,1,1,19,1,2023-06-03 20:25:24
21954,Meudon,17,3,20,2,1,2023-06-03 20:25:24
21952,Meudon,1,26,27,13,1,2023-06-03 20:35:26
21951,Meudon,1,0,1,21,1,2023-06-03 20:35:26
21953,Meudon,3,1,4,16,1,2023-06-03 20:35:26
21954,Meudon,18,3,21,1,1,2023-06-03 20:35:26
21952,Meudon,1,26,27,13,1,2023-06-03 20:45:28
21951,Meudon,1,0,1,21,1,2023-06-03 20:45:28
21953,Meudon,4,1,5,15,1,2023-06-03 20:45:28
21954,Meudon,18,4,22,0,1,2023-06-03 20:45:28
21952,Meudon,3,27,30,10,1,2023-06-03 20:55:30
21951,Meudon,1,0,1,21,1,2023-06-03 20:55:30
21953,Meudon,4,1,5,15,1,2023-06-03 20:55:30
21954,Meudon,18,4,22,0,1,2023-06-03 20:55:30
21952,Meudon,4,27,31,9,1,2023-06-03 21:05:31
21951,Meudon,2,0,2,20,1,2023-06-03 21:05:31
21953,Meudon,3,1,4,16,1,2023-06-03 21:05:31
21954,Meudon,17,4,21,1,1,2023-06-03 21:05:32
21952,Meudon,3,26,29,11,1,2023-06-03 21:15:33
21951,Meudon,2,0,2,20,1,2023-06-03 21:15:33
21953,Meudon,2,1,3,17,1,2023-06-03 21:15:33
21954,Meudon,17,4,21,1,1,2023-06-03 21:15:33
21952,Meudon,3,26,29,11,1,2023-06-03 21:25:35
21951,Meudon,2,0,2,20,1,2023-06-03 21:25:35
21953,Meudon,4,1,5,15,1,2023-06-03 21:25:35
21954,Meudon,16,4,20,2,1,2023-06-03 21:25:35
21951,Meudon,2,0,2,20,1,2023-06-03 21:35:37
21952,Meudon,2,27,29,11,1,2023-06-03 21:35:37
21953,Meudon,5,1,6,14,1,2023-06-03 21:35:37
21954,Meudon,16,4,20,2,1,2023-06-03 21:35:37
21952,Meudon,4,29,33,7,1,2023-06-04 09:30:49
21951,Meudon,4,0,4,17,1,2023-06-04 09:30:49
21953,Meudon,4,0,4,16,1,2023-06-04 09:30:50
21954,Meudon,12,6,18,3,1,2023-06-04 09:30:50
21952,Meudon,5,29,34,6,1,2023-06-04 09:40:54
21951,Meudon,4,0,4,17,1,2023-06-04 09:40:54
21953,Meudon,4,0,4,16,1,2023-06-04 09:40:55
21954,Meudon,12,7,19,2,1,2023-06-04 09:40:55
21951,Meudon,4,0,4,17,1,2023-06-04 09:50:57
21952,Meudon,5,29,34,6,1,2023-06-04 09:50:57
21953,Meudon,4,0,4,16,1,2023-06-04 09:50:58
21954,Meudon,12,7,19,2,1,2023-06-04 09:50:58
21951,Meudon,4,0,4,17,1,2023-06-04 10:01:01
21952,Meudon,5,29,34,6,1,2023-06-04 10:01:01
21953,Meudon,3,1,4,16,1,2023-06-04 10:01:01
21954,Meudon,13,7,20,1,1,2023-06-04 10:01:01
21952,Meudon,5,28,33,7,1,2023-06-04 10:11:06
21951,Meudon,4,0,4,17,1,2023-06-04 10:11:06
21953,Meudon,3,1,4,16,1,2023-06-04 10:11:07
21954,Meudon,14,7,21,0,1,2023-06-04 10:11:07
21952,Meudon,5,28,33,7,1,2023-06-04 10:21:10
21951,Meudon,4,0,4,17,1,2023-06-04 10:21:10
21953,Meudon,3,1,4,16,1,2023-06-04 10:21:10
21954,Meudon,14,7,21,0,1,2023-06-04 10:21:11
21952,Meudon,5,24,29,11,1,2023-06-04 10:31:13
21951,Meudon,3,0,3,18,1,2023-06-04 10:31:13
21953,Meudon,3,1,4,16,1,2023-06-04 10:31:13
21954,Meudon,14,7,21,0,1,2023-06-04 10:31:13
21952,Meudon,5,24,29,11,1,2023-06-04 10:41:15
21951,Meudon,3,0,3,18,1,2023-06-04 10:41:15
21953,Meudon,3,1,4,16,1,2023-06-04 10:41:15
21954,Meudon,14,7,21,0,1,2023-06-04 10:41:15
21952,Meudon,5,23,28,12,1,2023-06-04 10:51:17
21951,Meudon,3,0,3,18,1,2023-06-04 10:51:17
21953,Meudon,3,1,4,16,1,2023-06-04 10:51:18
21954,Meudon,14,7,21,0,1,2023-06-04 10:51:18
21952,Meudon,4,23,27,13,1,2023-06-04 11:01:19
21951,Meudon,3,0,3,18,1,2023-06-04 11:01:19
21953,Meudon,3,1,4,16,1,2023-06-04 11:01:20
21954,Meudon,14,7,21,0,1,2023-06-04 11:01:20
21952,Meudon,3,23,26,14,1,2023-06-04 11:11:21
21951,Meudon,3,0,3,18,1,2023-06-04 11:11:21
21953,Meudon,3,1,4,16,1,2023-06-04 11:11:21
21954,Meudon,14,7,21,0,1,2023-06-04 11:11:21
21952,Meudon,3,23,26,14,1,2023-06-04 11:21:24
21951,Meudon,3,0,3,18,1,2023-06-04 11:21:24
21953,Meudon,3,1,4,16,1,2023-06-04 11:21:24
21954,Meudon,14,7,21,0,1,2023-06-04 11:21:24
21952,Meudon,3,23,26,14,1,2023-06-04 11:31:26
21951,Meudon,3,0,3,18,1,2023-06-04 11:31:26
21953,Meudon,1,1,2,18,1,2023-06-04 11:31:26
21954,Meudon,14,7,21,0,1,2023-06-04 11:31:26
21952,Meudon,3,24,27,13,1,2023-06-04 11:41:28
21951,Meudon,3,0,3,18,1,2023-06-04 11:41:28
21953,Meudon,1,1,2,18,1,2023-06-04 11:41:28
21954,Meudon,15,6,21,0,1,2023-06-04 11:41:28
21952,Meudon,3,24,27,13,1,2023-06-04 11:51:31
21951,Meudon,3,0,3,18,1,2023-06-04 11:51:31
21953,Meudon,1,1,2,18,1,2023-06-04 11:51:31
21954,Meudon,15,6,21,0,1,2023-06-04 11:51:31
21952,Meudon,5,25,30,10,1,2023-06-04 12:01:34
21951,Meudon,3,0,3,18,1,2023-06-04 12:01:34
21953,Meudon,1,1,2,18,1,2023-06-04 12:01:34
21954,Meudon,15,6,21,0,1,2023-06-04 12:01:34
21952,Meudon,5,25,30,10,1,2023-06-04 12:11:37
21951,Meudon,3,0,3,18,1,2023-06-04 12:11:37
21953,Meudon,1,1,2,18,1,2023-06-04 12:11:37
21954,Meudon,15,6,21,0,1,2023-06-04 12:11:37
21952,Meudon,6,27,33,7,1,2023-06-04 12:21:40
21951,Meudon,3,0,3,18,1,2023-06-04 12:21:40
21953,Meudon,1,0,1,19,1,2023-06-04 12:21:40
21954,Meudon,15,6,21,0,1,2023-06-04 12:21:40
21952,Meudon,5,27,32,8,1,2023-06-04 12:31:42
21951,Meudon,3,0,3,18,1,2023-06-04 12:31:42
21953,Meudon,2,0,2,18,1,2023-06-04 12:31:42
21954,Meudon,15,6,21,0,1,2023-06-04 12:31:42
21952,Meudon,6,28,34,6,1,2023-06-04 12:41:44
21951,Meudon,3,0,3,18,1,2023-06-04 12:41:44
21953,Meudon,3,0,3,17,1,2023-06-04 12:41:44
21954,Meudon,15,6,21,0,1,2023-06-04 12:41:44
21952,Meudon,6,28,34,6,1,2023-06-04 12:51:52
21951,Meudon,2,0,2,19,1,2023-06-04 12:51:52
21953,Meudon,4,0,4,16,1,2023-06-04 12:51:52
21954,Meudon,15,5,20,1,1,2023-06-04 12:51:52
21952,Meudon,5,28,33,7,1,2023-06-04 13:01:55
21951,Meudon,2,0,2,19,1,2023-06-04 13:01:55
21953,Meudon,4,0,4,16,1,2023-06-04 13:01:55
21954,Meudon,14,5,19,2,1,2023-06-04 13:01:55
21952,Meudon,5,28,33,7,1,2023-06-04 13:11:57
21951,Meudon,2,0,2,19,1,2023-06-04 13:11:57
21953,Meudon,5,0,5,15,1,2023-06-04 13:11:57
21954,Meudon,8,5,13,8,1,2023-06-04 13:11:57
21952,Meudon,6,28,34,6,1,2023-06-04 13:21:59
21951,Meudon,2,0,2,19,1,2023-06-04 13:21:59
21953,Meudon,9,0,9,11,1,2023-06-04 13:21:59
21954,Meudon,7,5,12,9,1,2023-06-04 13:21:59
21952,Meudon,6,28,34,6,1,2023-06-04 13:32:01
21951,Meudon,2,0,2,19,1,2023-06-04 13:32:01
21953,Meudon,10,0,10,10,1,2023-06-04 13:32:01
21954,Meudon,7,5,12,9,1,2023-06-04 13:32:01
21952,Meudon,5,28,33,7,1,2023-06-04 13:40:00
21951,Meudon,2,0,2,19,1,2023-06-04 13:40:00
21953,Meudon,11,0,11,9,1,2023-06-04 13:40:00
21954,Meudon,6,5,11,10,1,2023-06-04 13:40:00
21952,Meudon,5,28,33,7,1,2023-06-04 13:50:11
21951,Meudon,2,0,2,19,1,2023-06-04 13:50:11
21953,Meudon,11,0,11,9,1,2023-06-04 13:50:11
21954,Meudon,6,5,11,10,1,2023-06-04 13:50:11
21952,Meudon,5,29,34,6,1,2023-06-04 14:00:13
21951,Meudon,3,0,3,18,1,2023-06-04 14:00:13
21953,Meudon,10,0,10,10,1,2023-06-04 14:00:13
21954,Meudon,6,6,12,9,1,2023-06-04 14:00:13
21952,Meudon,5,28,33,7,1,2023-06-04 14:10:15
21951,Meudon,3,0,3,18,1,2023-06-04 14:10:15
21953,Meudon,9,0,9,11,1,2023-06-04 14:10:15
21954,Meudon,7,6,13,8,1,2023-06-04 14:10:16
21952,Meudon,5,26,31,9,1,2023-06-04 14:20:17
21951,Meudon,3,0,3,18,1,2023-06-04 14:20:17
21953,Meudon,9,0,9,11,1,2023-06-04 14:20:17
21954,Meudon,7,5,12,9,1,2023-06-04 14:20:18
21951,Meudon,3,0,3,18,1,2023-06-04 15:12:05
21952,Meudon,4,26,30,10,1,2023-06-04 15:12:05
21953,Meudon,10,2,12,8,1,2023-06-04 15:12:05
21954,Meudon,6,5,11,10,1,2023-06-04 15:12:05
21951,Meudon,3,0,3,18,1,2023-06-04 15:22:08
21952,Meudon,3,24,27,13,1,2023-06-04 15:22:08
21953,Meudon,10,2,12,8,1,2023-06-04 15:22:08
21954,Meudon,6,5,11,10,1,2023-06-04 15:22:08
21952,Meudon,4,24,28,12,1,2023-06-04 15:30:32
21951,Meudon,3,0,3,18,1,2023-06-04 15:30:32
21953,Meudon,10,2,12,8,1,2023-06-04 15:30:32
21954,Meudon,5,5,10,11,1,2023-06-04 15:30:32
21952,Meudon,3,24,27,13,1,2023-06-04 15:40:36
21951,Meudon,3,0,3,18,1,2023-06-04 15:40:36
21953,Meudon,10,2,12,8,1,2023-06-04 15:40:36
21954,Meudon,5,5,10,11,1,2023-06-04 15:40:36
21952,Meudon,4,23,27,12,1,2023-06-04 17:03:23
21951,Meudon,2,0,2,19,1,2023-06-04 17:03:23
21953,Meudon,4,2,6,14,1,2023-06-04 17:03:23
21954,Meudon,8,4,12,9,1,2023-06-04 17:03:23
21952,Meudon,3,24,27,12,1,2023-06-04 17:13:26
21951,Meudon,2,0,2,19,1,2023-06-04 17:13:26
21953,Meudon,4,2,6,14,1,2023-06-04 17:13:26
21954,Meudon,8,4,12,9,1,2023-06-04 17:13:26
21952,Meudon,3,25,28,11,1,2023-06-04 17:23:29
21951,Meudon,2,0,2,19,1,2023-06-04 17:23:29
21953,Meudon,3,1,4,16,1,2023-06-04 17:23:29
21954,Meudon,7,4,11,10,1,2023-06-04 17:23:29
21952,Meudon,4,25,29,10,1,2023-06-04 17:33:32
21951,Meudon,1,0,1,20,1,2023-06-04 17:33:32
21953,Meudon,3,1,4,16,1,2023-06-04 17:33:32
21954,Meudon,7,4,11,10,1,2023-06-04 17:33:32
21952,Meudon,4,25,29,10,1,2023-06-04 17:43:35
21951,Meudon,1,0,1,20,1,2023-06-04 17:43:35
21953,Meudon,1,1,2,18,1,2023-06-04 17:43:36
21954,Meudon,7,4,11,10,1,2023-06-04 17:43:36
21952,Meudon,4,26,30,9,1,2023-06-04 18:07:00
21951,Meudon,1,0,1,20,1,2023-06-04 18:07:00
21953,Meudon,1,1,2,18,1,2023-06-04 18:07:01
21954,Meudon,7,3,10,11,1,2023-06-04 18:07:01
21952,Meudon,6,26,32,7,1,2023-06-04 18:17:05
21951,Meudon,1,0,1,20,1,2023-06-04 18:17:05
21953,Meudon,1,1,2,18,1,2023-06-04 18:17:05
21954,Meudon,6,3,9,12,1,2023-06-04 18:17:06
21952,Meudon,3,30,33,8,1,2023-06-04 18:27:09
21951,Meudon,2,0,2,20,1,2023-06-04 18:27:09
21953,Meudon,0,3,3,17,1,2023-06-04 18:27:09
21954,Meudon,7,3,10,13,1,2023-06-04 18:27:10
21952,Meudon,2,29,31,7,1,2023-06-04 18:37:12
21951,Meudon,1,0,1,20,1,2023-06-04 18:37:12
21953,Meudon,0,3,3,17,1,2023-06-04 18:37:12
21954,Meudon,5,3,8,13,1,2023-06-04 18:37:13
21952,Meudon,1,29,30,8,1,2023-06-04 18:47:15
21951,Meudon,1,0,1,20,1,2023-06-04 18:47:15
21953,Meudon,0,3,3,17,1,2023-06-04 18:47:16
21954,Meudon,6,2,8,13,1,2023-06-04 18:47:16
21952,Meudon,2,29,31,7,1,2023-06-04 18:57:18
21951,Meudon,1,0,1,20,1,2023-06-04 18:57:18
21953,Meudon,0,3,3,17,1,2023-06-04 18:57:19
21954,Meudon,6,1,7,14,1,2023-06-04 18:57:19
21952,Meudon,2,29,31,7,1,2023-06-04 19:07:22
21951,Meudon,1,0,1,20,1,2023-06-04 19:07:22
21953,Meudon,0,3,3,17,1,2023-06-04 19:07:22
21954,Meudon,5,1,6,15,1,2023-06-04 19:07:22
21952,Meudon,2,29,31,7,1,2023-06-04 19:17:25
21951,Meudon,1,0,1,20,1,2023-06-04 19:17:25
21953,Meudon,0,3,3,17,1,2023-06-04 19:17:25
21954,Meudon,5,1,6,15,1,2023-06-04 19:17:25
21952,Meudon,2,31,33,5,1,2023-06-04 19:27:28
21951,Meudon,1,0,1,20,1,2023-06-04 19:27:28
21953,Meudon,0,3,3,17,1,2023-06-04 19:27:28
21954,Meudon,5,1,6,15,1,2023-06-04 19:27:29
21952,Meudon,2,32,34,4,1,2023-06-04 19:37:31
21951,Meudon,1,0,1,20,1,2023-06-04 19:37:31
21953,Meudon,0,3,3,17,1,2023-06-04 19:37:31
21954,Meudon,4,1,5,16,1,2023-06-04 19:37:31
21952,Meudon,3,32,35,3,1,2023-06-04 19:47:34
21951,Meudon,1,0,1,20,1,2023-06-04 19:47:34
21953,Meudon,2,3,5,15,1,2023-06-04 19:47:34
21954,Meudon,4,1,5,16,1,2023-06-04 19:47:34
